####################################################################################################
#             #           #   #           #               #             #           # #             
### ##### ##### # ####### # # # ####### # ##### ######### # ##### ### ### # ####### # # ### ####### 
#   #   # #     # #     # # # # #   # # #     # #     #   # #     #   #   #   #     # # #   #   #   
# # # # ### ##### # ### # # # # # # # # ##### # ### ### ##### ##### ### ##### # ##### # # ### # # ##
# # # # #       # #   # # # # # # #   #   #   #   # #   #     #     #   #     #     #   # #   #     
# ### # # ####### ### # # # # # # ### ### # ### # # # ### ### ####### ### ######### # ### # ########
#     #     #     # # #   # # #   #     # #   # # # #   #   # #     #   # # #       # #   # #       
# ########### ##### # ####### ##### ##### ### ### # ### # # ### ### ### # # # ######### # ### ##### 
# # #         #       #       #     #     #       #   # # #   # # #     # # #   #       # #   #   # 
# # # ##### ######### # ####### ##### ############### # # ### # # ####### # ### ##### ##### ### # # 
# # #     # #   #   #   #     #   # #       #         # # #   #   #   #   # #       #       #   #   
# # ##### ### # # # ##### ### ### # ####### ####### ### # # # ### ### # ### # ##### ####### # ##### 
#       #     #   #     # # #     #       # #   #   #   # # #   # #   #   #   #   #       # #   # # 
####### ############### # # ########### ### # # # # # ### # ### # # ##### ##### # ####### ##### # # 
#     #     #         #   #             #   # #   # # #   # #   # #     #       #       #     # #   
##### ##### # # ########### # ### ##### # ### ##### # ##### ##### # # ################# ##### # # ##
#     #     # #       #     # #   #   # # #   #     #     # #     # #       #     #   # #   #   # # 
# ##### ############# # ##### # ### # # # # ############# # # ############# # ### # # # ### ##### # 
# #     #     #     #     #   #   # # # # #             # # #           #   # # # # #   #   #   #   
# # ##### ### # ### ####### ##### # # ### # ######### ### # ########### # ### # # # ##### # ### ### 
# #   #   # #   # # #       # #   # #     # #       #     #         #   #   # #     #   # #       # 
# ### # # # ##### # # ####### # ### ####### # ##### ####### ##### ### ##### # ####### # # ######### 
#   # # # #     #   #   #     # #   #       #   #   #     #   #   #   #     #   #     #   #     #   
### # # # ##### # ##### ##### # # ### ########### ### ### # # ##### ### ### ### ### # ##### ### # ##
#   # # # #   # #     #   #   # #   # #           #   #   # #   #   #   #     #   # #         #     
# # # # # # # # ##### # # # ### ### # ### # ####### ### # # ### # ### ### ####### # ############### 
# # # # #   # #   #   # # #   # # # #   # # #   #   #   # # #   # #   # # #       #       #     #   
# ### # ##### # # # ##### # # # # # ### ### # # # ### ##### # ### ### # # # ############### ### # ##
#   # #   #   # # # #     # #     #   #   #   #     #   #   #   # #   #   #           #       # #   
### # ### # ### # # # ######### ##### ### ####### ##### # ##### # # ### ############# # ####### ####
#   # #   # # # #   #     #   # #     # #       # #   # #   # #   # # #   #         #   #     #     
# ### ##### # # ##### ### # # # # ##### ####### # # # # ### # ##### # ### # ####### ##### ### # ### 
#   #       #   #     # #   # # #     #     #   # # # # #           #     #       # #   #   # # # # 
# # ######### ####### # ##### ####### ##### # ##### # # # ############# ######### # # ##### # # # # 
# #     # #   #     #     #   #     #     # #       # #   #   #       #         # # #     # # #   # 
# # ### # # ### ### ##### # ### # ####### # ######### # ### # # ##### ######### # # # # ### # # ### 
# # # #   #     # #     # #     #   #     #     #   # #   # #   #   #   # #   # # # # # #   # # #   
### # # ######### ##### ######### # # ####### # # # # # ### ####### ### # # # # # # ### # ### ### # 
#   #   #       #     # #       # # #   #     # # #   # #   #     #   # #   #     #     # #     # # 
# ##### # # ##### ### # # ##### ### ### # ####### ##### # ### ### # # # ### ##### ####### ##### # # 
# #   # # #       #   #   #   # #     # #       # #   # #     #   # # #   # #   # #     #     #   # 
# # # # # ######### ####### ### # ##### # ##### # ### # ####### ### # ### # # # ### ### ### # ##### 
# # # # # #       #         #   # #     #     #   #   # #   #   #   # #   # # # #   # #   # #     # 
# # # # # # ##### # ### ##### ### # ######### ##### ### # ### ### # ### ##### # # ### ### ####### # 
# # # # # # # #   #   #           # #     #   #           #   # # #   #       #   #     # #       # 
# # # ### # # # ################### ### # # ####### ####### ### # ### ################# # # ####### 
#   # #   # #   #     #         #   #   # #   #   #   #     #     # #   #           #   # # # #     
# ### # ### # ### ### # ####### # ### ### ### # # ### # ##### ##### # # ##### # ### # ### # # # ####
# #   # # # #   # # # #   #   #   #   #     #   #   # # #   #   #   # #     # #   #   #   # #   #   
### ### # # ### # # # # # # ######### # ########### ### ### ### # ### ##### ##### # ### ### # ##### 
#   #   # #   #   #   # # #     #     # #     #     #   #   #   #   #     #     # # #   #   # #     
# # # ### ### ##### ### # ##### # # ##### # ### ##### ### ### ##### ##### ##### # ### ### ### # # # 
# # # #   #   #   # # # #     # # #       # #   #   # #   #   #       #   #   # # #   #     # # # # 
# ### ### # ### ### # # ##### # # ######### # ### # # # ### ### ##### # ### # # # # ####### # ### # 
#         # #     # #   #     # # # #     # #     #   # #   #   #   # #     # # # #       # # #   # 
# ######### # ### # # ### ##### # # # ### # ########### # ### # # # ######### # # ####### # # # ### 
#     #     # # #   # #   #         # #   #         #   # # # #   # #       # # # #   #   # #   # # 
### ### ##### # ####### ### ##### ### # ### ####### # # # # # ##### # ##### # # # # # # ### ##### # 
#   #   #   #     #     #   #   # #   # #   #   #   # # # #   #   # #   #   # #   # #   #   #     # 
# ### ##### ##### # ##### ### # ### ### # ### ### ### # # ### ### # ### # ### ### # ##### ### ##### 
# # #     #     # #   # # # # #     #   #   #         # #   #     #   # #   #   # #   #   #         
# # ##### # ##### # # # # # # ####### ##### # ############# ##### ### # ### ### ##### ### ####### ##
#   #   # #   #   # # #   # # #     #     # # #     #     #   #   # # # #     #     #   #   #   # # 
### ### # # # # ##### # ### # # # ####### # # # ### # ### ### # ### # # # # ##### # ### ### # # # # 
#       # # #   #     #     # # #   #       # # # #     #   # # #   #   # # #   # # #   #   # # #   
######### ### ##### ### ##### # ### # ######### # ##### # ### # # ####### ### # ### # ### ### # ### 
#  S#   #   #     # #   #   # #   #     # #     # #   # #     #   #     #   # #   # # #   #   #   # 
# ### # ### ##### # ##### # # ######### # # ##### # # ### ######### ### ### # ### # # # ### ##### ##
# #   #     #   #   #     # #         #   # #     # #   #         # # #     #   #   # #   #     #   
# # ######### # ##### ##### ### ##### ##### ##### # ### ######### # # ### ##### ##### # # ##### ### 
#   #         # #     #   #   #     #     # #     #   # #       #   #     #     #     # #   #   # # 
##### ####### # ### # # # ### ##### ##### # # ####### # # # ### ### ####### ##### ######### # ### # 
#   #   #     #   # #   # # #     # #   #   #   #     # # #   # #   #       #   #         # # #   # 
# # ### # ####### ####### # ##### # ### ####### # ##### # ### ### ### ##### # # ######### # # ### # 
# #     #       # #   #   #       #   #         # #     #   #       #   #   # #         # #   #   # 
# ####### ##### # # # # ### ######### # ### ##### # ####### ########### ##### ### ### ### # ### ### 
#   #   # #   # #   # # # #       #   #   # #     # #         #   #   #     # # #   # #   #     #   
##### # # ### # ##### # # ####### # ##### ### ##### # ######### # # # ##### # # ### ### ####### # # 
#   # # #     #   #     #         #       #   #   # #     #     #   #       # #   #     #   #   # # 
# # # # ##### ### ####### ############### # ### ### ####### ############### # # # ####### # # ### ##
# #   #     #   #   #   #   #       #   # #   #   # #   #   #       #     # # # # #     # # #   #   
# ######### ### ### # # ### # ##### # # ##### # # # # # # ### ### # ### ### # ### # # # # ##### ### 
# #       # #   #   # #   # #   # # # #       # #   # #   #   #   #   # #   #   #   # # # #     #   
# ### # # # ##### ##### ### ### # # # ######### ##### ######### ##### # # ##### ##### # # # ##### # 
#   # # # #     #   #   #   #   #   #         #       #         #   #   #   #   #     #   #   #   # 
# # ### # ##### ### # ### ### ### ### ####### ######### ######### # ##### ### ### ########### # ####
# # #   # #   #   # #         # # #     #   #   #             #   #   #   #   #   #   #     # #     
# # # ### ### ### # ########### # # ##### # ### # ########### # ##### # ### ### # # # # # ### ##### 
# # #   #     # #   #   #         # #     # #   # #         #   # #   # #   #   # # #   #   #   # # 
# # # # ##### # # ### # ### ######### ##### # ### ### ##### ##### # # # # ### # ### ####### ### # # 
# # # #     #   # #   #   #           #   # #   #     #           # # # # #   #   # #   #   #     # 
### # ##### ### # # ##### # ########### # # ### ########### ####### ### # ####### # # # # ### ##### 
#   #   #   #   # # #     # #       #   # #   # #         # #     #     #   #   #     # # #   #   # 
# ####### ####### # # ### ### ##### ##### ### # # ####### ### ### ######### # # # ##### # # ### # # 
#   #   #         # #   # #   #   # #   #       #   #   # #   # #   #   #   # # # #   # # # #   # # 
# # # # # ######### ### ### ### # # # # # ######### # # # # ### ### # # # ### # # # # ### # # ### # 
# #   # # #       #   #   # #   # #   # #   #       # # #   #     #   # #   # # # # #   #   # #   # 
# ##### ### ##### ### ### # ### # ##### ##### ######### ####### # ##### ### # # ### ### ##### # ### 
#     #         #       #       #     #                         #     #       #     #         #    E
