####################################################################################################
#     #         #         #       # #           # #       #             # #             #         # 
# ### ####### ### # ##### # ##### # # ##### ### # # # ### ####### ##### # # ##### ##### # ##### # # 
# #     #   #     # #   #   #   #   # #   #   #   # # # #     #   #     #   #   # #   # #   #   #   
# ##### # # ### ### # # ##### # ##### # ##### ##### # # ##### # ####### # ### # ### # # ### # ##### 
#   #   # #   # #   # # #   # # #     #     #       # #       #       # #   # #     # #   # # #     
### # ### ### ### ### # # # # # # ##### ### ######### ##### ####### # # ##### ####### # # # # ######
#   #   # # #   #   # #   #   # #   #     #         #     #       # # #     #     #   # #   #       
# ##### # # ### ### # ######### ### ##### ####### # ##### ####### ### ##### # ### # ### ######### # 
# #   # # #     #   # #       #   #     #     #   #     #   #   #   #   #   #   # # # # #       # # 
# # ### # # ##### ### # ##### # # ##### # ##### ### ####### # # ### ### # ### ### # # # # ##### ### 
# #   # # # #     #   # #       # #     # #     #   #       # #     #   # #   #   # #   # #   # #   
# # # # # # # ##### ### ########### ####### ##### ### ####### ####### ### ##### ### # ### # # # # # 
# # #     # #         # #         # #       #   # # #   # #   #         #       # # #   # # #     # 
# ######### ### ####### # ####### # # ######### # # ### # # ######### # ######### # ### # ######### 
# #     #     # #   #   # #     #   #         #   #   # # # #       # #     #     #   # #       #   
# # ### ##### # ### # # # # # # ##### ####### # ##### # # # ### ### # ##### ##### ### ######### # ##
# # # #   #   #   # # # # # # # # #       #   #       # #     #   # # #   #     #   #         # #   
# # # ### ### ### # # ### ### # # # ####### ### ##### # ##### ### # # # # ##### # ########### # ### 
# #     #   #   #   #   #   # # #     #     #   #   # #     #     # #   # #     #               #   
# # ####### ### ##### # ### # # ##### # ### ##### # # ##### ####### ####### ### ####################
# # #       # #     # #   # # #     # # # # #     # # #   # #   #   #   #   #   #             #     
# # # ####### ##### ### ### # ##### ### # # # ##### # ### # # # # ### # # ####### ########### # ### 
# # #   #   #           #   # #   # #   #   # # #   #     #   # # #   # #   #     #   #     # # # # 
# # ### # # ######### ### ### ### # # # ##### # # ######### ### # # # # ### # ##### # # ### # # # # 
#   # #   # #       # #   #     # #   # #     #           # # # # # # #   #         #   #   # # # # 
# ### ##### # ##### ### ####### # ##### # ##### ######### # # # # ### ### ############### ### # # # 
#   #   #   # #   # #   #       #     # #     # #   #   # #   # #     # #     #   #   #   # #     # 
### ### # ### # ### # ### ####### ##### ##### ### # ### # ### # ####### ##### # # # # # ### ####### 
# #     #   #   #   #   # #       #         #     #   # # #   # #           # # # # #           #   
# ##### ### ### # ##### # ##### ### ########### ##### # # ##### # ######### # # # # ############# # 
#   #     #   # #       # #   #       #      S#     # #   #   # # #   #   # # # # # #   #       # # 
### # ####### # ######### # # ##### ### ########### # # ### # # # # # # # ### # # # # # # ##### # # 
#   # # #     # #   #       # #   # #   #     #     # #     #   # # #   # #   # # # # #   #   #   # 
# ### # # ### # ### # ####### # # ### ### # # ### ### ########### # ##### # ### ### # ##### ####### 
#       # #   #   #   #   #   # #     # # # #   # #   #           # # #   # #   #   #     #     # # 
####### # ####### # ### ### ### ####### # # ### ### ########### # # # # ### # # # ####### ### # # # 
#     # #     #   # #   #   #   #     #   #   #     #           # #   #     # # # # #   #   # #   # 
# ### ####### # ### # ### # # ### ##### ##### ####### ### ####### ### ####### ### # # # ### # ##### 
# # # #       #   #   #   # # # #       #   #   #   # #   #   #   # #   #       # # # #   # #       
# # # # ##### ### ##### ##### # # ####### ##### # # # # ### # # ### ### # ##### # # # # ### # ######
# # #   #   #   #   #   #   # #   #       #   # # #   # #   # #       # #   #   # #   # #   #       
# # # ### # ####### # ### # # # ### ##### # # # # ####### ### ####### # ### # # # ##### # ######### 
# #   #   # #     # #   # # # #     #     # #   # #   #     #   #   # # #   # # #     # #     # #   
# ### # ### # # ### ### # # # ####### ##### ##### # # # ####### # # # # ### # ####### # ##### # # ##
#   # # #   # #   #     # #   #     # #     #     # # # # #     # #   #   # #     # #   #   # # #   
# # ### # ### ### ### ### ##### ### ### ##### ##### # # # # ### ######### ##### # # # ### # # # ### 
# #     #       #     #   #     #   #   #   #     # #     # #   #       #     # #   # #   # # #     
# ################# ### ### # ##### # ### ### ### # ##### # ##### ### # ##### # ### # # ### # ### ##
#   #         #   #   # # # #     # # # #     # #   #   # #         # # #   # # #   # # # # #   #   
### ####### ### # ### # # # ##### # # # # ##### ##### # ### ######### # # ### # ##### # # # ### ####
#   #       #   #   # # # # #   # #   # # #         # #   # #   #     #   #   # #     # # # #   #   
# ### ##### # ##### ### # # # # # ##### # # ####### # ### ### # # ######### ### # ##### # # # # # # 
# #       # #   #   #   # #   # #   #     # #       #   #     #   #         #   # #   # #     # # # 
# ####### ### ### # # ### # ##### # # ##### # ######### ######### # ######### # # # # # ######### # 
# #       #   #   # #   #   #   # # #     # #   #   #   #       # # #         # #   # #   #       # 
# # ### ### ### # ##### ##### # # # ##### # ### # # # ### ##### ### # ######### ##### ### # ####### 
#   #   #   #   # #   #       # # #     # # # #   # #     #   # #   #   #     #     # #   # #   # # 
######### ### ##### # ######### # ##### # # # ##### ####### ### # ##### # ### ####### # ### # # # # 
#       # # # #     #   #       #   #   # # # #             #   #     #     # #   #   #     # #   # 
# ##### # # # # ##### ### ########### ### # # # ######### ### ####### ####### # # # ######### ##### 
# #   #   # #   #   # #   #           # #   #   #       # #   #       #     #   #   #         #     
# # # ##### ##### # # # ### ##### ##### ### ##### ##### # # ### ####### ### ### ##### ####### # ### 
# # #             # # #   #   #   # #       #     # #   # #   # #     # # #   # #   #       # #   # 
# ### # ########### # ### ##### ### # ####### ##### # ####### # ### # # # ### # # # ####### # ### ##
#   # #   # #       #   # #     #     #             #     #   #   # #   #   # #   #         #   #   
### ##### # # ######### # # # ######### ########### ##### # ##### # ##### # # # ######### ######### 
# #       # #   #   #   # # # #     #   # #     #   #   # #   #   # #   # #   # #     # # #       # 
# ######### ### # # # ### # ### ### # ### # ### ### ### # # # # ### # # # ####### ### # # # ##### # 
#     #       # # # #     #       # # #   # # #   #     # # # # #     # #         # # #   #   # #   
# ##### ##### # ### ############# # # # ### # ### ##### # # # # ####### ########### # # ##### # ### 
#     #     # # #             # # #     #   #   # #   # # # #           #   #     #   # # #   #   # 
# ### # ##### # # ########### # # ####### ### # # # # # # ############### # # ### # ### # # ##### # 
# # #   #     # # # #   #     # #     #   #   #   # # # # #   #     #     # # # # #   #   #     # # 
# # ##### ### # # # # # # ##### # ##### ####### ### # ### # # # ### ### ### # # # ### ######### # # 
# # #     #   #   #   # #   #     #     #     # #   #     # #     #   #   # #   #   #           #   
# # # ################# ### ####### # ### ### # ### ##### # ######### ### ##### # # ############# ##
# # #                 #   #   #     # #   # # #     #     # #       #   #     # # # #   #   #   # # 
# # ############# ### # # ### # ####### ### # ####### ##### # ##### # # ##### # # # # # # # # # # # 
#     #         # # # # # # # #             # #       # #   #   #   # #   #   # # #   #   # # #   # 
##### ######### # # # # # # # # ############# # ##### # # ##### # ####### # ### # ########### ##### 
# #             # # #   #   # #   #   # #     # #   #   # #     #     #   #     # #         #   #   
# # ####### ##### # ##### ### ### # # # # ##### # # ##### # ######### # # ####### # ####### ### # ##
#   #     # #   # #   #   #   #     #   #   #   # #       #         #   # #     # #   #   #   # #   
##### ### # # # # # ### ### ### ########### # ### ########### ##### # ##### ### # ### # # # ### ### 
#   # #   # # #   #   # #   #   #         # # #     #       # #     # #       # #   # # # #   # #   
# # # # ##### ##### # # # ### ### ####### # ### ##### ##### # # ####### ####### # # # # # ### # # # 
# #   # #     #     # # #   #   # #   #   #   #   #   #   # # #         #       # #   # #   #   # # 
# ##### ### ######### # ### # ### # # # ### # # ### ### # # ##### ####### # ##### ##### ######### ##
#     #     #       #   # # # #   # # # # # #   #   #   # #     #   # #   # #   # #     #           
# ### # ##### ##### ### # # ### ### # # # # ##### # ##### ##### ### # # ##### # # ### ### ######### 
#   # # #     #   #   #   #     #   # # #       # # #   #       #     #       # #   # #           # 
# ### # # ####### ### ########### ### # ####### # ### # # ########### ######### ### # # ########### 
# #   # #   #     # #           #   # # #   #   #     # # #         #       #   #   #   #     #     
### ####### # ### # ##### ##### # # # # # # ### ####### # # ####### ######### ### ####### ### # ### 
#   #     #   # #   #     #     # # # # # #   # #   #   # # #   # #         # #           #   # # # 
# # # ### ##### # ### ########### # ### # ### # # # # ### # # # # ######### # ############# ### # # 
# # #   #   #   # #   #     #   # # #   #   # #   # # #   #   # #     #     #       #     #     # # 
# ##### ### # # # # ### ### # # # # # ##### # ####### # ####### # # ### ########### # ########### # 
#         #   #   #       #   #   #         #         #         # #                 #              E
