####################
# #     # #         
# # ### # # ### ####
#   #   #   # #     
# ### ##### # ##### 
#   #    S#     #   
### ######### ### # 
#   #       # #   # 
# ####### # ### ####
# #       #   #     
# # ######### ##### 
#   #   #   #       
##### # ### ####### 
#     #     #       
### # ##### # ######
#   # #   # # #     
# # ### # # # ##### 
# # #   # # #   #   
# ### ### ##### # # 
#       #         #E
