####################
#         #     #   
# ##### # ### # # # 
#   #   #     # # # 
# ### ######### # # 
# #   #     #   # # 
# # ### ##### ### # 
# #   # #     # # # 
##### # # ##### # # 
#     #     #     # 
# ### ##### ### ### 
#   # #   #   # # # 
# # # # # ### # # # 
# # # #S# #   #   # 
# # ##### # ####### 
# # #     # #   #   
# # # ##### # # # ##
# # # #   # # # #   
# # # # ### # # ### 
# #   #       #    E
