####################
#               #   
# ### ##### ##### # 
# # # #   # #   # # 
# # # # # ### # # # 
# # #   #     # # # 
# # ######### # # # 
# #   #S#   # #   # 
# ### # # # # ##### 
#   # #   # #   # # 
### # ##### ### # # 
# #     # # #     # 
# ##### # # # ##### 
# #   # # # # #   # 
# # # # # # ### # # 
#   # # # #   # #   
##### # # ### # ### 
#     # #   # # # # 
# ##### ### # # # # 
#           #   #  E
