####################################################################################################
#   #       #     #       #       #       #   #         #         #             # #       #         
### # # ### # ### # ##### ### ### # ### # # # # # ##### ##### ### # # ######### # # ##### # ##### # 
#   # #   #   # # #     #   #   #   # # #   # # #   #   #   # # #   #     #   # #   #   # # #   # # 
# ### ### ##### # ##### ### ### ##### # ##### # ### # ### # # # ##### ### # ### # ##### # # # # # # 
#     # #   #   #   #   # #   #       #   #   # #   #     # #   #   # #   # #   #       #   # # # # 
# ##### ### # # ### # ### ### ####### ### ##### # ######### ##### # ### ### # ##### ######### # # ##
# #   # #   # #     # #     # #     # #   #     # #       # #     # #   #   #     # #   #     # #   
# # # # # ######### # # ### # # # ### # ### ##### # # ##### # ##### # ### ####### ### # # ##### ### 
#   #   #         #   # #   # # #   # #   # #   # # #     #   #   # # #         #     #   #   #   # 
####### ######### ####### ### # ### # ### # # # # # ##### ##### ### # # ####### ########### # ### # 
#     # #       # #       #   #   #     #   # #   #     # #           #   #       #       # #     # 
# # ### # ##### # # # ##### ########### ##### ########### # ############# # ### ### ##### # ####### 
# #     # #   # # # # #   # #     #   #     #   #       #           #   # # # # #   #   #   #   #   
# ######### # # # # # # # # # ### # # ### ##### # ##### ####### ##### # ### # # # ##### ##### # ### 
# #   #     #   # # #   # # # #     # #   #     #   # #   #     #     #   # #   # #     #     #     
# # # ### ####### ### ### # # ####### # ### ### ### # ### ##### # ####### # ##### # ### # # ####### 
#   #   # #     #   #   # # #   # #   # #   # # #   # #   #   # # #   # # #       #   # # # #       
####### # # ### ### ### # # ### # # ##### ### # # ### # # # # # # # # # # ##### ### # # ### # ######
# #     # # # #     # # #   #   #   #     #     #     # # # # # #   #   #     # # # # #   # # #     
# # ##### # # ####### # ##### ##### ### ############# # ### # ######### ##### # # # # ### # ### ### 
# # #     # #         # #         #     #         #   #     #       #   # #   # #   # # #   #     # 
# # ##### # ####### ### # ##### # ##### # ##### ### ############### # ### # ### ##### # ### # ##### 
# #     # # #     # #   # #   # #   #   # #   #     #       #     #   #   # #       # #     # #     
# ##### # # # ### # # ### # # # ### ### # ### ####### ##### # ########### # ####### # ####### # ### 
#         # # #     # #   # # #   #   # #     #   #   #   # #             #   #     #         #   # 
######### # # ####### # ### # ### ### # ##### # # # # # ### ######### ### ### ### ### ##### ##### # 
#       # # #   #     #   # # # #   # #   # # # # # # #             #   #   #   #   # #   #     # # 
# ##### ### ### # ######### # # ### # ### # # # # ### # ########### ### ### ### ### ### # ##### # ##
# #   # #   #   # #     #   # #     #   #   #   #   # # #       # # #   #   # # #     # #   #   #   
# ### # # ### ### # ### # ### ######### # ######### # ### ##### # # # ### ### # ##### # ### ####### 
#   # #   #       # # # # #     #       # #     #   #     # #   # #   #       #   #     # #       # 
### # ##### ####### # # # ##### # # ####### ### # ### ##### # ### ##### ##### ### ####### ####### # 
#   #     # #   #   #   # #   #   # #       # #   #         # #         #   # # #   #       #   #   
# ####### # # # ### # ### # # ##### # ####### ############### ##### ##### # # # ### # ### # ### ### 
# #       #   # #   # #     #     # # #                 #   #     # #   # # #   #   # #   #     #   
# ### ######### # ### ##### ##### # # ####### ######### # # ##### # # # # # ### # ##### ### ##### ##
#   #   #     #   # # #   #     # # # #       #   #       # #     # # #   # #   #   #   # # #   #   
### ### # ### ##### # # # ####### ### # ######### # ####### # ####### ##### ####### # ### # # # ### 
#   #   #   #   #     # #       #   # #         #   #   #   #   #     #   # #     # # #     # #     
# ### ##### ### # ##### ####### # # # # ####### ##### # # ### # # ##### # # # # ### # ####### ######
# #       #   #   #     #     # # # # # #   # #   #   # # #   #   #   # # #   #   # #         #     
# ### # # ### ##### ### # # ### ### # # # # # ### # ### # ### ##### ### # ##### # # # ######### ### 
#   # # # # #   #   #   # # #   #   # #   #   #   #   # #   # #     #   #     # # # #     #     #   
### ### # # ### # ### ### ### ### # # ######### ##### # ### # ### # # ####### ### # ####### ##### ##
#   #   #     # # # #   # #   #   # #     #     #     # #   #     # #   #   #     #             #   
# ### ####### # # # ### # # ### ### ##### # ### # ##### ### ### ##### # # # ####################### 
# #   # #     # # #   # # #   #   # #     # #   # #   #   #   # #   # # # #   #             #       
# # ### # ##### # ### # # ### ### ### ##### ### # ### ### ### # # # # # # ### # ##### # ##### ##### 
# # #   #     # #   # # #   #     #   #   #   # # #   # #   # # # # # # #   #   #   # # #   # # #   
# # # # ### ### ### # # ### ##### # ### # ### # # # # # ### # ### # ### ### ##### # ### # # # # # ##
# # # #     #   #   # #   #       # #   # #   # #   #   #   #     #   #       #   #     # #   # # # 
# # ### ##### ### ### ### ######### # ### # ##### ####### ########### # ####### # ##### # ##### # # 
# #   #   #   # # #   #   #       #   #   # #   # #   #   #           # #     # # #   # # #   # #   
# ### ### # ### # # # # # # ##### ##### ### # # # # # # ### ############# ### # ### # # # # # # ### 
#   #   # # #   # # # # # # # #   #   #   #   # # # # # #                 # # #     # # #   # #     
### # # ### ### # # ### # # # # # ### ### # ### # # # # ################### # ####### ####### ##### 
#   # #   #   #   # #   # # # # #     #   # #   # # #   #     #           #   #     #       #     # 
# ### ### ### ### # # ##### # # ####### ### # # # # ### # ### ### ### ### # ### ### ####### ##### ##
# #     #   #   #   # #     # #       # #   # # # #   # # # #   #   # # # #     # #         #   #   
# ##### ### ### ##### # ##### ####### # ##### ### ### # # # ### # ### # # ####### ######### ### ### 
# #   #   #   # #   #     #     #   # #     #     # # # #S#   # # #   #     #   #     #     #     # 
# # # ##### ### # # ##### # ##### # # ##### # ##### # # ##### # ### ####### # # # # ### ##### ##### 
# # #     #   #   #   #     #     # # #     #   #   # #       #   #       #   # # #     #         # 
# # ##### # # ####### # ##### ##### # # ####### ### # ### ####### # ##### ####### ############### # 
# # #     # #     #   # #     #   #   # #     #     # #   #     # #     #           #           # # 
# # # ####### # ### ##### ##### ### ### # ### ##### # ##### ### # ################# # ######### # # 
#   #       # # #   #     #     #   #   #   # #     #       #   # #         #   #     #   # #     # 
# ######### # ### ### ####### # # ### ##### # ############### # # # ####### # # ####### # # # ##### 
#   #   # # #       # #     # # # #   #     # #               # #   #   # # # #   #     # #     #   
### # # # # ####### # # ### # # # # ### ##### # ##################### # # # # ### # ##### # ##### ##
# #   #   #   #   #   # #   # #   # #   #   # #             #         # # #   # #   #   # # #     # 
# ####### ### # # # ### # ######### ### # ### # ########### # # ####### # ##### ##### # # ### ##### 
#       #   #   # # #   # #         #   # #   #     #     #   #       # #       #     # #     #     
# ### ##### ##### ### ### # ######### ### # ##### ### ### ### ####### # # # ### ### ### ####### ### 
# # #     #     #     #   #     #     #   # #     #   # #   # #   #   # # # # #     #   # #       # 
# # ##### ##### ####### # ##### ### ### # # ### ### ### ### ### # # ### # # # ### ##### # # ##### # 
#   #       #   #   #   #   #   #   #   #     # #   #     #     # # # # # # #     #   # #   #     # 
# ### ### ### ### ### ####### ### ########### ### ### ### ####### # # # # # ####### # # ### # ##### 
# #   #   #   #     # #       #             #   #   # #     #     # #   # #         # #   # # #     
### ### ### ####### # # ####### ########### ### ### # ####### ##### # ##### ######### ### ### ######
#   # #   # #       #   #     # #         # #       #   #     #     #     # #     #   #     #       
# ### # ### # # ######### # # # # ##### # # ######### # # ##### ######### # # # ### # ##### ####### 
# #   # #   # #     #     # # # #     # # #     #     #   #       #     # #   # #   # #   #         
# ### # # ### ##### # ##### ### # ##### ##### # # ##### ######### # # ### ##### # ##### # ######### 
#   #   # # #     #     #   #   # #     #   # # # #   # #         # #         # #     # # #     #   
# # ##### # ##### ####### # # ##### ### # # ### # # # # # ################### ### ### # # # ### # ##
# # #     #       #   #   # #     # #   # # #   # # # #   #     #         #     # #   # #   #   # # 
# # # ##### ####### # # ######### # ##### # # ##### # ##### ### # ####### ##### ### ### ##### ### # 
# #   #     # #     # # #     #   # #     # #     # #     # # #         #     #     #     #   #     
# ######### # # ##### # # # ### ### # ##### ##### # ##### # # ############### ####### ##### ####### 
# #       #   #   #   #   #     #   #     #     #     # # #       #         #         # #   #   #   
# # ### # ### ### ### ### ####### # ##### ##### ##### # # ### ##### ####### ####### ### # ### # ####
# #   # #   #   #   #   #     #   # #   #     #     #   # #   #   # #     # #     #     #     #     
# ##### ### ####### ### ##### ### # # # # ### ##### ##### # ### # # ### # # # ### ##### ########### 
#     #   #   #     # #   #       # # # #   #     #     #   #   # #   # # # #   #     #           # 
##### ### ### # ##### ### ### ####### # ######### ##### # ### ### ### ### # # # ##### ### ######### 
#   #     # # #     #   #   # #     # # #         #   # # #   # #   #   # # # # #     #   #     #   
# ######### # ##### # ##### ### ### # # # ######### # # ### ### ### ### # # ### # ######### ### # # 
#                   #           #     #   #         #       #           #       #           #     #E
