E# #   #     #   #   # #     #       # #   # #       # # # #   #   # # # # # # #   # #   # #       #
 # ### ##### ### # ### ##### ####### # ### # ####### # # # ### ### # # # # # # ### # ### # ####### #
   #               #       # #   #   # # # # #               #     #   #   # # # #   #   # # # # # #
 ############### ######### # ### # ### # # # ############# ### ####### # ### # # # ##### # # # # # #
 # # # #   #   # # #   # #           # #     # # #     # #   # #   # #   #   # #   #   # # #   # # #
 # # # ### ### # # ### # ##### ##### # # ##### # ##### # ### # # ### # ### ### # ### ### # # ### # #
       # # # # # # # # # # # # #             #   #       #   # # #       # #         # #   #     # #
###### # # # # # # # # # # # ############# ##### ##### ##### # # ##### ### ####### ### # ### ##### #
 #       #   # # # #   #   #   # #             #   # # # #     # # #   # #   # #   #   #   #     # #
 ####### # ### # # ### ### ### # ########### ### ### # # # ##### # ### # # ### ### # ### ####### # #
     #   #   # # # #     # # #     #             #   # #   # #   #   #   # # #     # #   # # #     #
#### # ##### # # # ### ### # # ################# ### # # ### ### ### # ### # ##### # # ### # ##### #
     # #       # #       # #   #   # # # #     # #     #   # # # #   # #   # #   #   # #   #       #
#### # ##### ### ####### # # ##### # # # ##### # # ####### # # # ### # ### # # ##### # # ######### #
     # # #   # #       #   #   # # # #   # #   # # # # #           # #       #     # #   # #     # #
#### # # ### # ####### ### ### # # # # ### ### # # # # ##### ####### ### ##### ##### # ### ##### # #
   #     #     # # #         # #     # #       # # #   #     # #   #       #     #   #     # #   # #
## ##### ##### # # ######### # ##### # ####### # # ### ##### # ### ####### # ####### ### ### ### # #
 # #     # #   # #   #   # #   #   # # #     #         # #   #   # # # # # # #   #     #   #   #   #
 # ##### # ### # ### ### # # ##### # # ##### ######### # ### ### # # # # # # # ####### ### ### ### #
 # # # #   #   # # #       #   #   # # #   # # #         #     #     # #         # #     #   # #   #
 # # # ### ### # # ##### ### ##### # # # ### # ######### ##### ##### # # ######### ##### # ### ### #
         #   # #     #   #   #   #   # # #       #                   # #         #         #       #
 ####### ### # # ####### # ##### # ### # ### ##################### ### # ########### ############# #
 #     # # #   # #     # #       # # #     #     # #     # # #     #               #   #   # #     #
###### # # # ### ##### # ####### # # # ####### ### ##### # # ##### ##### ########### ##### # ##### #
   #         #   #   #     # #     #   # #   # # #     #   # # #       #   #   #   #   # # # # # # #
## ######### # ##### ##### # ##### ### # # ### # ##### ### # # ##### ##### # ##### # ### # # # # # #
 #     #     # # # #   # #   #   #   # #       #           #   # # #   # #   # # # #     # #   #   #
 ### ####### # # # ### # ### ### ### # # ############### ##### # # ### # # ### # # ### ### # ### ###
   #     #       # #     # #   # # #   #   # # #           # # #   #         #     #   # #   # #   #
 ####### ####### # ##### # ### # # ### # ### # ########### # # # ##### ########### # ### # ### ### #
 # #     # #         #     #   # # #   # # #       # #   #   #       # # #   # #       # # #     # #
 # # ##### ######### ### ##### # # # ### # ####### # ### ### # ####### # ### # ##### ### # ##### # #
 #       # # #     #     #   # #     #   # # # #         # # # #   # # # # # # # # #   #     # # # #
 ####### # # ##### ##### ### # ### ##### # # # ##### ##### # # ### # # # # # # # # # ####### # # # #
     # #   #   #   #   # #     #   #   #   # # #     # #   # #   #   #     # #     # # # #   # # # #
#### # ### ### ### ### # ##### ### # ### ### # ##### # ### # ### # ##### ### ##### # # # # ### # # #
 # #   #   #   # # # # #   #   # # # #   # # # #     # # # # # # # # # #   # # #   # #     # # # # #
 # ### ### # ### # # # ### ### # # # # ### # # ##### # # # # # # # # # ### # # # ### ### ### # # # #
 # #               #   #   #       # # # #   #       # # # # #   # # #   # # # # #     # # # # # # #
 # ############### # ##### ####### # # # # ######### # # # # # ### # ### # # # # ### ### # # # # # #
 # #       # #       # # # #   # # # #     #       #     #   # #   # # # # # # # #   # #   # # # # #
 # ####### # ####### # # # ### # # # # ########### ##### # ### ### # # # # # # # # ### ### # # # # #
 # # #       # #                 # #     #   #     # #       #   #   # # # #         # # #   #   # #
 # # ####### # ################# # # ####### ##### # ### ####### # ### # # # ######### # ### # ### #
     # # #       # #       #   # # #     #   #         # #   # #   # # # #     #     # # # # # #   #
#### # # ##### ### ####### ### # # ### ##### ######### # # ### # ### # # ### ### ##### # # # # ### #
 #   #   #   # #   # #       #   # #     # #             #   #   # # # #     # #   # # # #   # # # #
 ### ### ### # ### # ####### ### # ### ### ############# # ### ### # # ### ### # ### # # ### # # # #
   #   #     #   # #     #       # #   #   #     #         # #       #     # #     # #   # #       #
 ##### ##### ### # ### ######### # ### # ##### ########### # # ######### ### # ##### # ### ####### #
 #   #         # # # #     # #   # #   # # #     # # #         # #   # #   # #       #   # #       #
 ### ######### # # # ##### # ### # # ### # ##### # # ######### # # ### ### # # ####### ### ####### #
 # #                       #     # # # # # # #   #   # # # # #   # # #   # #   # #       #   #   # #
 # ########### ########### ##### # # # # # # ### ### # # # # # ### # ### # ### # # ######### ### # #
   # # #       # #   # #                 # #   #       # # # # #     # #   # # #   #   # #   # # # #
## # # ######### ### # ### # ####### ##### ### ##### ### # # # # ##### ### # # # ### ### ### # # # #
 #   # #               #   # #         # #     #   #   # # # #     # # # #       # #     # #     # #
 ### # ############### ############### # ### ##### ### # # # ##### # # # ##### ### ### ### ##### # #
           #         #   #     # #     # # # #     #   #     # # #   #   #   # # # #   # # #   # # #
########## ######### ### ##### # ##### # # # ##### ### ### ### # # ### ##### # # # ### # # ### # # #
 #       # # #   #               #   #     #     # # # #   # # #   # #   #     # #   #   # # # #   #
 ####### # # ### ############### ### ##### ##### # # # # ### # # ### ### ##### # # ### ### # # ### #
                   # #     #   #         #   #     # #     #   # # # #   #   # #             # # # #
########## ####### # ##### ### ######### # ####### # ### ##### # # # # ##### # ### ########### # # #
 # # #     #         # # #   # #   #   #   # # #     # # # #     # # # # #   # # # # #       # #   #
 # # ############### # # ### # ### ### ### # # ##### # # # ##### # # # # # ### # # # # ####### ### #
     # # # #                     #   #           # #     #   #     # # # # #   # # #     #   # #   #
## ### # # ######### ########### ### ########### # ##### ### ##### # # # # # ### # # ####### # # ###
 #   # #             #     #       #     # #   # # # #     #   # # #   #   # #   # # # #   # # #   #
 ### # ################### ####### ##### # ### # # # ##### # ### # # ##### # ### # # # # ### # # ###
               #     #       #     # # #   #   #   #   #   # # # #   #     #   # #       #       # #
 ### ######### ##### ####### ##### # # ### ### ### # ##### # # # # ### ##### ### ### ##### ####### #
 #   #                                           #   #     #         # # #   # # # # # #     #     #
############## ### ##### # # ### # # ##### ##### ### ##### ### ##### # # ### # # # # # # ######### #
   #   # # #   #   #     # # #   # # #     #       #   #   # # #   #   # #   # # # #   # #   # #   #
 ##### # # ############### ##################### ##### ### # ##### ### # # ### # # # ### # ### # ###
         #                 #                                           #   # #       #       # # # #
######## ####### ############### ############### # # # # # ########### ### # # ####### ####### # # #
                 # #   # #       #               # # # # # # # #         #     # # #   # # #     # #
###### ### ####### ### # ####### ####### ### # # # # ####### # ### ##### # ##### # # ### # # ##### #
       #   #                     #       #   # # # # #             #    S                          #
###### ############### # ### ##### # ####### # # ####### # ####### # # ### # ### # # # # # ##### # #
       #               # #     #   # #       # # #       # #       # # #   #   # # # # # #     # # #
#### # # # # ##### # ####### ##### ########### # ####################### ### # ### ### ### # ### ###
     # # # # # #   # #       #     #           # #                         # #   #   #   # #   # # #
###### ####### ####### # # # # ######### # ### ### ##### ######### # ### # ### # # ### ### # ##### #
       #               # # # # #         # #   #   # # # #         #   # #   # # #   #   # #       #
 # ########### ### # ####### ####### ####### ####### # ##### ### # ####### # ##### ### ######### ###
 # #           #   # #       # #     # #     #               #   #     #   #     #   #         #   #
## ### # ### ### # # ######### ####### ####### ########### # # # ### ### ### ### # ##### # ### ### #
     # # #   #   # # # #                       #           # # # #     # #   #   #     # #   # #   #
## # ##### # ### ##### ####### ### # # # # # # # ### ############# # ####### ### # # # ### ####### #
   # #     # #   #             #   # # # # # # # #   #             #     #   #   # # #   #       # #
 ### # ################### # # ##### ############### ### # # # # # ### # # # ### # # ##### ####### #
   # # #                   # #   #   #               #   # # # # # #   # # # #   # #     #       # #
## ########### ####### # # # # ##### ############### ##### ### # # # ####### ### # # # ### #########
   #           #       # # # # #       #             #     #   # # # #         # # # #   #         #
####################################################################################################
