 #       # # #   #   # # # #         # # #   # #   #     #   # #     #     # # #               # #E#
 ####### # # ### # ### # # # ######### # ### # ### ##### # ### # ##### ##### # # ############### # #
 #   #   # #     # #   #   # # # # #   # #   # #   # # #   #       #   # # # #   #           # #   #
 ### ### # ### ### # ### ### # # # # ### ### # ### # # ### # ######### # # # # ### ########### # ###
         # # # #   # # #   #   #     # #   #       #       # #   # # # # # #           # # # # #   #
######## # # # # ### # # ### ### ##### ### # ############# # # ### # # # # # ########### # # # ### #
 #   #   # # #     #   #     #   # # #   #   #   #         # #   # #       #                   # # #
 ### ### # # # ##### ####### # ### # # ##### # ####### ##### # ### # ####### ##### ### ######### # #
 #   # # #   #   #     # # #     #   # # # #   #   #     #       #   #   #       #   # # #     #   #
 ### # # # ### ##### ### # # ##### ### # # ### # ####### # ####### ##### # ############# ##### ### #
     #   # # #               #         # #   #   # # # # # #   # # # #           # #   #   # # # # #
#### ### # # # ############### ######### ### # ### # # # # # ### # # # ########### # ##### # # # # #
   #             #     # # # # # # #   # #   #     #     #       #   #               # #   # # #   #
 ############# ##### ### # # # # # ### # ### ##### # ####### ##### ### ############### # ### # # ###
 #   # # #   #     # # #   # # # # # # #   #   #   #   # # #   # # # #         #     #     # # #   #
 ### # # ### ### ### # # ### # # # # # ### ### # ### ### # # ### # # # ######### ##### ##### # # ###
 # #   # #   # # # #   # # # # #   #       #   # #         #       #               #   # # # # # # #
 # ### # ### # # # ### # # # # # ### ######### # # ############# ### ####### ######### # # # # # # #
 #   # #   #     #   # # #   # #     # # # #   # # #     #   #         # # # #   # #   # #     # # #
 ### # ### ##### # ### # ### # # ##### # # ### # # # ####### ### ####### # ### ### # ### # ##### # #
 #   #       #   #   #   #   #     # # # #   #   #   # #   #   #   #     #       #             #   #
 # ####### ##### # ### ##### # ##### # # # ##### # ### ### # ### ### ##### ####### ############### #
 #   # # #   #     #     # #                     #         # # # #     #   # #         #       #   #
 ### # # # ####### # ##### # ####################### ####### # # # ##### ### # ##### ####### ##### #
 # # # # #   #     # #   #     # #   # # #   #   #   #     # # #     #             #   # # #   # # #
 # # # # ### ##### # # ##### ### # ### # ### # ### ##### ### # # ##### ##### ########### # # ### # #
   # #   #   # #       # #         #   # # #   #       #   #               #         #         # # #
## # # ##### # ### ##### ### ####### ### # # ### ####### ### ############################# ##### # #
     #           # #   #     #     #     #   # # #   #     # #   # # #     #       # #         #   #
#### ########### # # ### ##### ##### ####### # # ### ##### # # ### # # ####### ##### # ########### #
   # #   # #   #   # #             #     #   # # # #     #           # #                 # # # # # #
 ### # ### # ### ### # ####### ####### ##### # # # ### ### ########### # ################# # # # # #
         #   #   #           #     # # # #   # #   # #   #   #   #                 #   # # # #   # #
 ####### ### ### # ################# # # # ### # ### # ### ### ### ### ############# ### # # ### # #
 # # # # #   #       # #   #     # #     # # #     #   # # #         #     #       #       # # # # #
## # # # # ####### ### ### # ##### ### ### # ### ### ### # # ############### ######### ##### # # # #
 #   #   #     #   #           # # #   #   #       #     # #             # # #   #     # # # # #   #
 ### ### ##### ### # ########### # ### # ##### ####### ### # ############# # # ##### ### # # # ### #
   #   # #     #       #   # # # # #     # #   #     #           # #       # # #   # # #   # #   # #
## ### # ##### # ######### # # # # ### ### # ### ####### ######### ### ##### # # ### # ### # ### # #
     # #   #   #   #   # # #   #     # #     #                           #   # #   # # #       #   #
#### # ### # ### ### ### # # ##### ### # ##### ########################### ### # ### # # ######### #
 # # # # # # # # # # #     # #       #   #         # # #         # # #           #   #     #   #   #
 # # # # # # # # # # # ##### # ######### # ######### # # ######### # # ############# # ####### ### #
 # # #     #     #                         # #   # # # #       # #     #   #   #   #     #   # #   #
 # # # ######### # ######################### # ### # # ### ##### # ##### ##### ### ### ##### # ### #
 # # #   # # #   #   # #     # #   # #   #     # #       #     # # #   #   # # # #     #     # # # #
 # # ### # # ### # ### # ##### # ### # ### ##### ### ##### ##### # # ### ### # # ### ### ##### # # #
   # # #     #         # # #   # # # #   # #   # # # #     #       #   #     #   #   #   # #       #
## # # ##### # ######### # ### # # # # ### # ### # # # ##### ######### # ##### ##### # ### # #######
   # # #             #   # # # #     #   # #   # #     #     #     # # #   #     # # # # # #   # # #
## # # ### ############# # # # ### ### ### # ### ### ### ##### ##### # # ### ##### # # # # # ### # #
 #       #   #   #     #   #   # #             # # #     #           #   #   #   #   # #       # # #
 ####### # ### ### ##### ### ### ### ########### # # ##### ########### ### ##### ### # # ####### # #
     # #           # #     #   # #           #   # #   #   # #       #               # #           #
#### # # ########### # ##### ### ### ######### ### # ### ### ### ##### ############### ### #########
   # #     #     #     # #         #         #                   # # # #   # # #   # # #   #   # # #
## # # ##### ##### ##### # ######### ########### ################# # # # ### # # ### # # ### ### # #
     #   # #   #   # # #   #   #                 # #           #   #   # #                         #
#### # ### # ### ### # ### ### ### ############### # ########### ##### # ### ################# #####
         #   # #     #           # #   #                   # # #     #             #       # #   # #
######## # ### ### ### ########### ### # ################### # ### ### ############# ####### ##### #
   # # # #   #                               #               #   # #                         #   # #
## # # # # ##### ################# ### # ##### ############### ### # ################### ##### ### #
 #   # # # #   #   #   #         # #   #           #   # #                             #           #
 ### # # # # ### ### ### ######### # ### # ######### ### ####### ##### # ###########################
 #   #       #     #             # #   # #                           # #           # #   #   # #   #
 ### ##### ### ##### ################### # # ### # # ### # # # ##### # ### ######### # ### ### # ###
   # # #   # #                     #   # # # # # # #   # # # #     # #   #                         #
 ### # ### # # ##################### ######### ############# # # # # # ################# # # # # # #
     # #   # #   #           # #                 #         # # # # # #                 # # # # # # #
## ### ### # # ### ########### # ################# ##################### # ##### # # ### # # ##### #
         #               # #                                           # #     # # #   # # #   #   #
 ######### ############### # ##################################### ##### ##### #####################
     #   #         # # #               # #       # #             #     #     #     # #     # # #   #
 ##### ### ######### # # ############### # ####### # ############################### ### ### # ### #
   #                                                   #       # # #       # #     # #           # #
 ### ################################################### ####### # # ####### ##### # # ########### #
  S              #                           #   #     #                                 # #   #   #
 ### # ### # ##### ##### ##### # # # ######### ### ##### ############# ### ######### ##### # ##### #
   # # #   #           #     # # # #                                 # #   #       #               #
 ### # # # ### ##################### ### # ### # # # # ### # ### ############# ### # # # # ### ### #
   # # # #   #                     #   # #   # # # # #   # #   #   #             # # # # # #     # #
 # ### ### # # # ### # ############### ### ##### ##### ############# ####### ####### ### ### # # # #
 # #     # # # #   # #           #   #   # # # #     #     #       # # #   #     # #   # #   # # # #
#### ##### ### ### ### ########### ######### # ############# ####### # # ######### ##### ### # ### #
         #   #   #   #                     #   # #     #   #     # #           # #     # # # # #   #
 # # ### # # ##### ### # ### # ############### # # ##### ### ##### # ########### # ####### ### ### #
 # #   # # #     # #   #   # #   #     # # #                                                 # #   #
## # ### # ### ################### ##### # ### ################# # # # ########### # ##### ####### #
   # #   #   #                                                 # # # #           # #   #       #   #
 ##### ##### ### ### # # ####### ### ### ##### # ####### ########### # ### ############# # # # ### #
     #     # #   #   # #       # #   #     #   #       #           # #   # # #       # # # # #   # #
 ####### ##### ### ### ### # ######### ####### ##### ##### ### ############# # ####### ########### #
       #     #   #   # #   #         #     #   #         # #     #                         #     # #
 # # # # ### ####### # # # ######### ### # # # ### # ############# ############### ######### ##### #
 # # # #   #       # # # #         # #   # # # #   #                             #     #       #   #
 # # # # # # # ####### ##### ### # ######### ### # ### ################# ### ##### # ### ###########
 # # # # # # #       #   #   #   #         # #   # #                   #   #     # #               #
####################################################################################################
