E  # # #   #   #         # #   #     # # #   
## # # ### ### ######### # # ##### ### # ### 
 # #           #   # # # # # # # #         # 
 # ######### ##### # # # # # # # ### ### ### 
 #   # # #   # # # # # # # #           # #   
 # ### # ### # # # # # # # # ############# ##
   #     # # #   # # # #           # #       
## # ##### # ### # # # ### ######### # ######
         #     # # # #   # # #     # #       
## ##### ##### # # # ### # # # ##### # ######
   #                   # # #     #           
###### ####### ####### # # # ##### ####### ##
       #   #   #        S                # # 
## ##### ############# # # ### ### # ####### 
   #                   # #   #   # #         
 ### # ##### # # # ##### # ### ##### ### # ##
 #   # #     # # # #     #   #     #   # #   
 ######### # ########### # ### ### ### ######
   #       # #           #   #   #   #       
#############################################
