       # #
## ### # #
   #  S  #
###### # #
       # #
#### ### #
     #   #
#### # ###
E    #   #
##########
