##########
#S#       
# ### ### 
#   #   # 
### ### # 
#   #   # 
# ### ### 
#   #   # 
### ###E# 
#       # 
